		11111			111




10000   		001



11111  111