 SO ./mandatory/assets/textures/banner.xpm




NO ./mandatory/assets/textures/wood.xpm   


EA ./mandatory/assets/textures/blue.xpm    





WE      ./mandatory/assets/textures/brick.xpm   




F 193,213,132
C 200,200,255



11111111111111111111111111111111111  1111111111111111111111111
111111111111111111111111111111111111111111111111111111111111
111000000000000000000000000000000000000000000000001111111111
111000000000000000000000000000000000000000000000001111111111
111000000000000000000000000000000000000000000000001111111111
1110000000000000000010000000000000000000000000000001111111111
111000000000000000000100000000000000000000000000001111111111
111000000000000000001 110000000000000000000000000001111111111
1110000000000000000001000000S00000000000000000000001111111111
111000000000000000000000000000000000000000000000001111111111
1110000000000000000000000000000000000000000000000011111   1111     
1110000000000000000000000000000000000000000000000011111111111    
111111111111111111111111111111111111111111111111111111111111     
111111111111111111111111111111111111111111111111111111111111