
  SO      ./mandatory/assets/textures/banner.xpm 
        NO     ./mandatory/assets/textures/wood.xpm     

WE    ./mandatory/assets/textures/brick.xpm  


EA ./mandatory/assets/textures/blue.xpm      


C 233,119,119

F 255,186,186    

     
  111111111111111111111   111111111111111111111111111111111111111
111111111111111111111111111111111111111111111111111111111111
11100000000000000000000000000000000000000000000001111111111
111000000000000000000000000000000000000000000000001111111111
111000000000000000000000000000000000000000000000001111111111
1110000000000000000010000000000000000000000000000001111111111
111000000000000000000100000000000000000000000000001111111111
111000000000000000000000000000000000000000000000001111111111
1110000000000000000000000000S00000000000000000000001111111111
111000000000000000000000000000000000000000000000001111111111
111000000000000000000000000000000000000000000000001111111111             1
1110000000000111100000000000000000000000000000000011111111111           101
1111111111111    11111111111111111111111111111111111111111111111      1111   1   1
111111111111111111111111111111111111111111111111111111111111 111